1 15 25
#########################
#   1 ** * WB* b F1    p#
# # # #*# # #*#*# # # #*#
#  x*  3  ***1 f1  s P* #
# # # # # #*# # #*#*# # #
#     4    x **  *  *   #
# # # # # # # # # #*# #*#
#*  *  5   *  *         #
# # # # #*# # # #*#*# # #
#*    **  *       *     #
# #*# # # # # # #*# # # #
#      6    *   *  *    #
# #*# # # # # # #*# # # #
#  8   7    *   *  *    #
#########################