1 15 25
#########################
#      ** * WB* b F1   p#
# # # #*# # #*#*# # # #*#
#  x*     ***  f   s P* #
# # # # # #*# # #*#*# # #
#          x **  *  *   #
# # # # # # # # # #*# #*#
#*  *      *  *         #
# # # # #*# # # #*#*# # #
#*    **  *       *     #
# #*# # # # # # #*# # # #
#           *   *  *    #
# #*# # # # # # #*# # # #
#           *   *  *    #
#########################