1 15 25
#########################
#                       #
#                       #
#                       #
#                       #
#                       #
#           * p         #
#                       #
#                       #
#                       #
#                       #
#                       #
#                       #
#                       #
#########################