1 15 25
#########################
#p       7** *    *   *  #
# # # #*# # #*#*# # # #*#
#  x* 7    ***   *    * #
# # # # # #*# # #*#*# # #
#f         x ** 2*  *   #
# # # # # # # # # #*# #*#
#*  *      *  *  3      #
# # # # #*# # # #*#*# # #
#*    **  *  4    *     #
# #*# # # # # # #*# # # #
#    8     5*   *  *    #
# #*# # # # # # #*# # # #
#      7  6 *   *  *    #
#########################