1 15 25
#########################
#      ** * WB* b F    p#
# # # #*# # #*#*# # # #*#
#  x*   6 ***1 f   s P* #
# # # # # #*# # #*#*# # #
#  2  3    x **  *  *   #
# # # # # # # # # #*# #*#
#*  *  4   *  *         #
# # # # #*# # # #*#*# # #
#*    **  * 5     *     #
# #*# # # # # # #*# # # #
#      67   *   *  *    #
# #*# # # # # # #*# # # #
#     8     *   *  *    #
#########################