1 15 25
#########################
#      ** * WB* b F1   p#
# # # #*# # #*#*# # # #*#
#  x*     ***  f   s P* #
# # # # # #*# # #*#*# # #
#  2  3    x **  *  *   #
# # # # # # # # # #*# #*#
#*  *  4   *  *         #
# # # # #*# # # #*#*# # #
#*    **  * 5     *     #
# #*# # # # # # #*# # # #
#      67   *   *  *    #
# #*# # # # # # #*# # # #
#     8     *   *  *    #
#########################