1 15 25
#########################
#p      1** *    *   *  #
# # # #*# # #*#*# # # #*#
#  x* 1    ***   *    * #
# # # # # #*# # #*#*# # #
#f         x ** 2*  *   #
# # # # # # # # # #*# #*#
#*  *      *  *  3      #
# # # # #*# # # #*#*# # #
#*    **  *  4    *     #
# #*# # # # # # #*# # # #
#    8     5*   *  *    #
# #*# # # # # # #*# # # #
#      7  6 *   *  *    #
#########################