1 15 25
#########################
#      ** * WB* b F    p#
# # # #*# # #*#*# # # #*#
#  x*     ***1 f   s P* #
# # # # # #*# # #*#*# # #
#  2  3    x **  *  *   #
# # # # # # # # # #*# #*#
#*  *      *  *         #
# # # # #*# # # #*#*# # #
#*    **  *       *     #
# #*# # # # # # #*# # # #
#           *   *  *    #
# #*# # # # # # #*# # # #
#           *   *  *    #
#########################