1 15 25
#########################
#      ** *    *5  *   p#
# # # #*# # #*#*# # # #*#
#  x*  4  ***   *     * #
# # # # # #*# # #*#*# # #
#f     3   x **  *  *   #
# # # # # # # # # #*# #*#
#*  *  2   *  *         #
# # # # #*# # # #*#*# # #
#*    **  *  6    *     #
# #*# # # # # # #*# # # #
#      1    *   *  *    #
# #*# # # # # # #*# # # #
#       7   *   *  *    #
#########################