1 15 25
#########################
#      ** * 1  *5  *   p#
# # # #*# # #*#*# # # #*#
#  x*     ***  *      * #
# # # # # #*# # #*#*# # #
#f    2    x **  *  *   #
# # # # # # # # # #*# #*#
#*  *  3   *  *         #
# # # # #*# # # #*#*# # #
#*    **  *       *     #
# #*# # # # # # #*# # # #
#      4    *   *  *    #
# #*# # # # # # #*# # # #
#           *   *  *    #
#########################