1 15 25
#########################
# 3    ** *    * 7 *   p#
# # # #*# # #*#*# # # #*#
#  x* 1   ***   *     * #
# # # # # #*# # #*#*# # #
#f    2    x **  *  *   #
# # # # # # # # # #*# #*#
#*  *      *  *  6      #
# # # # #*# # # #*#*# # #
#*    **  *       *     #
# #*# # # # # # #*# # # #
#       5   *   *  *    #
# #*# # # # # # #*# # # #
#     4     *   *  *    #
#########################