1 15 25
#########################
#      ** *   * *  s   p#
# # # #*# # #*#*# # # #*#
#  x*    f***1    b   * #
# # # # # #*# # #*#*# # #
#  2  3      **  *  *   #
# # # # # # # # # #*# #*#
#*  *      *  *         #
# # # # #*# # # #*#*# # #
#*    **  *    3  *     #
# #*# # # # # # #*# # # #
#  2    P   *   *  *    #
# #*# # # # # # #*# # # #
#       2   *   *  *    #
#########################