1 15 25
#########################
#                       #
#                       #
#                       #
#                       #
#         *****         #
#   7         *     p   #
#             *         #
#         *****         #
#                       #
#                       #
#                       #
#                       #
#                       #
#########################