1 15 25
#########################
#p     ** * WB* b F     #
# # # #*# # #*#*# # # #*#
#  x*     ***  f   s P* #
# # # # # #*# # #*#*# # #
#            **  *  *   #
# # # # # # # # # #*# #*#
#*  *      *  *         #
# # # # #*# # # #*#*# # #
#*    **  *       *     #
# #*# # # # # # #*# # # #
#           *   *  *    #
# #*# # # # # # #*# # # #
#           *   *  *    #
#########################