1 15 25
#########################
#p**    #   1   #    2  #
#  ###  # ###   # ###   #
#***#b*** *#**** *s#* **#
#  ###    ###     ###   #
# 4    *     #   f      #
#  *    #    *    #     #
#   *  ###  *    ###    #
#  *    #    *    #     #
#    3      4           #
#     #  2    # #    *  #
#    ###      P##  3  * #
#     #       # #    *  #
#          4            #
#########################